

   NO              ./path_to_the_north_texture
SO       ./path_to_the_south_texture
WE ./path_to_the_west_texture    
EA ./path_to_the_east_texture

F    250, 100, 0
C 225,30,0


        1111111111111111111111111 
        1000000000110000000000001
        1011000001110000000000001
        1001000001100000000000001
111111111011000001110000000000001
10000000001100000111101111111111
11110111111111011100000000001
11110111111111011101010010001
11000000110101011100000010001
10000000000000001100000010001
10000000000000001101010010001
11000001110101011111011110N011111
11110111011101010101111010001
11111111111111111111111111111